-----------------------------------------------------------------------------------------------------------------------------------
-----------------------------------------------------------------------------------------------------------------------------------
-----------------------------------------------------------------------------------------------------------------------------------
-----------------------------------------------------------------------------------------------------------------------------------
-----------------------------------------------------------------------------------------------------------------------------------
-----------------------------------------------------------------------------------------------------------------------------------
-----------------------------------------------------------------------------------------------------------------------------------
-----------------------------------------------------------------------------------------------------------------------------------
---------%%-----------------------------------------------------------------------------------------%---------%---------%----%-%--%
---------||%--------------------------------------------------------------------------------------%-|--L------|---------|----|-|--|
---------|||-------------%---%-----------------------%--------%----------%------------------------|-|%--%%-%%-|---------|---%|%|--|
---------|||%--------%-%-|%--|-----------------------|--------|----------|------------------------|-||--||%||-|--%------|---||||--|
--------%||||---%----|-|-||--|---------------------D-|%-------|--------%-|---1--------------------|-||%%|||||-|--|------|---||||-S|
------%-|||||---|----|-|-||--|-----------------------||-----%%|--------|-|------------------------|-|||||||||-|--|------|---||||--|
---%--|-|||||---|---%|-|-||--|-----------------------||-----|||-----%--|-|---r--------------------|-|||||||||-|%-|------|---||||--|
XXX|XX|X|||||XX-|XXX||X|X||XX|XXXXXXXXXXXXXXXXXXXX-XX||XXXXX|||XXX-X|X-|X|XXXXX-XX-XXXXXXXXXXXXXXX|-|||||||||-||X|-XX--X|XXX||||XX|
